Name,Volume,Ask Size,Ask Price,Bid Size,Bid Price,Last Price,Shares Matched,Shares Routed
UVXY,2195367,0,0.00,0,0.00,9.97,2187977,7390
IEFA,1323504,0,0.00,0,0.00,67.55,1317478,6026
USMV,1151282,0,0.00,0,0.00,76.35,1140437,10845
VXX,900184,0,0.00,0,0.00,17.28,897991,2193
ARKG,727160,0,0.00,0,0.00,27.74,687106,40054
CBOE,683463,0,0.00,0,0.00,181.99,678355,5108
GOVT,489221,0,0.00,0,0.00,22.40,485474,3747
INDA,439907,0,0.00,0,0.00,46.02,419213,20694
EFV,437386,0,0.00,0,0.00,50.51,427095,10291
IGV,416410,0,0.00,0,0.00,391.97,414834,1576
USHY,348616,0,0.00,0,0.00,35.59,342094,6522
EZU,306911,0,0.00,0,0.00,45.52,300814,6097
UVIX,292125,0,0.00,0,0.00,17.42,285747,6378
VIXY,267338,0,0.00,0,0.00,17.26,264905,2433
ITB,261878,0,0.00,0,0.00,87.07,258304,3574
IAGG,228013,0,0.00,0,0.00,50.03,226225,1788
SVXY,178427,0,0.00,0,0.00,98.00,176798,1629
ICSH,167955,0,0.00,0,0.00,50.48,167955,0
ITM,166027,0,0.00,0,0.00,45.82,157091,8936
BBJP,154059,0,0.00,0,0.00,52.16,146000,8059
QUAL,134408,0,0.00,0,0.00,141.06,129351,5057
COWZ,132008,0,0.00,0,0.00,49.98,129275,2733
FLOT,127108,0,0.00,0,0.00,50.86,104584,22524
MOAT,126007,0,0.00,0,0.00,79.38,126006,1
EFAV,122546,0,0.00,0,0.00,67.38,120135,2411
CALF,120352,0,0.00,0,0.00,43.16,120136,216
NOBL,118723,0,0.00,0,0.00,91.10,118256,467
AAAU,104457,0,0.00,0,0.00,20.16,104222,235
ECH,102162,0,0.00,0,0.00,26.87,102104,58
ICF,97996,0,0.00,0,0.00,54.86,97696,300
VNM,97882,0,0.00,0,0.00,13.10,95982,1900
REM,95049,0,0.00,0,0.00,22.72,94879,170
SVIX,92260,0,0.00,0,0.00,34.62,91366,894
BBAX,92034,0,0.00,0,0.00,46.19,86311,5723
PDEC,89605,0,0.00,0,0.00,34.25,89405,200
JMST,87494,0,0.00,0,0.00,50.75,87494,0
EFG,79010,0,0.00,0,0.00,92.14,77267,1743
HYD,74885,0,0.00,0,0.00,50.50,73654,1231
TLTW,73209,0,0.00,0,0.00,28.37,67978,5231
BBEU,69150,0,0.00,0,0.00,54.06,65107,4043
ESGV,67735,0,0.00,0,0.00,80.83,67381,354
MTUM,67184,0,0.00,0,0.00,150.11,65167,2017
EEMV,65251,0,0.00,0,0.00,54.54,62185,3066
GVI,62595,0,0.00,0,0.00,103.06,62495,100
ACWV,60274,0,0.00,0,0.00,98.77,56455,3819
IDV,58852,0,0.00,0,0.00,26.72,58852,0
HEFA,58526,0,0.00,0,0.00,31.00,58326,200
DFIC,57560,0,0.00,0,0.00,24.36,55535,2025
BBCA,55715,0,0.00,0,0.00,60.71,55615,100
KNG,52705,0,0.00,0,0.00,49.88,52705,0
PAVE,52415,0,0.00,0,0.00,31.49,51315,1100
ITA,50880,0,0.00,0,0.00,119.86,50880,0
SLVP,50221,0,0.00,0,0.00,10.18,50221,0
NEAR,48758,0,0.00,0,0.00,50.39,48558,200
JEMA,46454,0,0.00,0,0.00,35.80,46454,0
VUSB,41086,0,0.00,0,0.00,49.40,41086,0
BUFR,39841,0,0.00,0,0.00,25.76,36915,2926
IBHF,36480,0,0.00,0,0.00,22.79,36480,0
BITX,36401,0,0.00,0,0.00,19.24,30482,5919
SPYI,33168,0,0.00,0,0.00,47.57,33166,2
OMFL,32180,0,0.00,0,0.00,48.12,31882,298
ICOW,30634,0,0.00,0,0.00,30.22,28238,2396
CNYA,30352,0,0.00,0,0.00,27.28,28452,1900
SMMD,28006,0,0.00,0,0.00,55.83,27786,220
GOVZ,27502,0,0.00,0,0.00,10.96,27051,451
BUFF,26926,0,0.00,0,0.00,39.16,20621,6305
GCOW,25872,0,0.00,0,0.00,33.24,25749,123
RDVI,25867,0,0.00,0,0.00,21.68,25867,0
IBHH,24872,0,0.00,0,0.00,22.75,24372,500
DISV,24554,0,0.00,0,0.00,24.65,24167,387
NVDX,24251,0,0.00,0,0.00,30.01,24251,0
NULG,23685,0,0.00,0,0.00,65.65,23665,20
GHTA,23508,0,0.00,0,0.00,26.35,23508,0
LQDW,22963,0,0.00,0,0.00,30.66,15761,7202
BDEC,22232,0,0.00,0,0.00,37.09,22232,0
VLUE,20569,0,0.00,0,0.00,94.65,20546,23
NURE,20293,0,0.00,0,0.00,28.08,20293,0
SMDV,20277,0,0.00,0,0.00,58.43,19977,300
IEO,20246,0,0.00,0,0.00,94.07,20146,100
XMAR,18766,0,0.00,0,0.00,32.53,18766,0
FBCG,18735,0,0.00,0,0.00,31.62,18721,14
IYZ,18688,0,0.00,0,0.00,21.65,16193,2495
ARKQ,18646,0,0.00,0,0.00,52.81,18638,8
FJUL,17842,0,0.00,0,0.00,40.20,13542,4300
IBHD,17563,0,0.00,0,0.00,23.35,17563,0
NUMV,17284,0,0.00,0,0.00,29.59,17184,100
PSFF,17130,0,0.00,0,0.00,25.28,17130,0
MLN,15708,0,0.00,0,0.00,17.69,14156,1552
ICVT,15480,0,0.00,0,0.00,74.99,15186,294
NULV,15246,0,0.00,0,0.00,35.16,15246,0
WTAI,14835,0,0.00,0,0.00,18.69,14136,699
SMOT,14749,0,0.00,0,0.00,28.91,11249,3500
BBRE,14736,0,0.00,0,0.00,82.05,14516,220
BBUS,14685,0,0.00,0,0.00,82.43,14685,0
JMUB,14456,0,0.00,0,0.00,50.14,14456,0
LBO,13992,0,0.00,0,0.00,25.30,13992,0
OUSM,13923,0,0.00,0,0.00,36.30,13923,0
CEMB,13727,0,0.00,0,0.00,42.97,13727,0
VOTE,13372,0,0.00,0,0.00,53.33,13372,0
DIHP,13279,0,0.00,0,0.00,24.48,13179,100
FGRO,12738,0,0.00,0,0.00,17.85,9831,2907
LVHI,12641,0,0.00,0,0.00,28.27,8311,4330
DFIS,12377,0,0.00,0,0.00,22.84,12377,0
SMIN,12127,0,0.00,0,0.00,67.87,12127,0
PICK,11781,0,0.00,0,0.00,40.61,11542,239
BALT,11373,0,0.00,0,0.00,28.41,10663,710
CEFS,10554,0,0.00,0,0.00,18.52,10554,0
SYLD,10425,0,0.00,0,0.00,62.81,10425,0
TAIL,10293,0,0.00,0,0.00,12.68,10293,0
IYJ,10285,0,0.00,0,0.00,107.02,10189,96
IFRA,10282,0,0.00,0,0.00,37.65,9652,630
NUSC,10015,0,0.00,0,0.00,35.50,9185,830
GNOV,9812,0,0.00,0,0.00,30.94,9812,0
TMFC,9623,0,0.00,0,0.00,43.09,9123,500
JCPB,9288,0,0.00,0,0.00,45.68,8717,571
VSGX,9160,0,0.00,0,0.00,53.02,8866,294
BBIN,8846,0,0.00,0,0.00,54.82,8846,0
XSHQ,8838,0,0.00,0,0.00,36.50,8838,0
PWS,8587,0,0.00,0,0.00,25.98,8587,0
GSUS,8553,0,0.00,0,0.00,62.71,8153,400
PTLC,8499,0,0.00,0,0.00,41.90,8299,200
IYT,8276,0,0.00,0,0.00,244.45,8276,0
ESML,8113,0,0.00,0,0.00,34.35,8088,25
MBCC,8025,0,0.00,0,0.00,28.27,4471,3554
UDEC,7903,0,0.00,0,0.00,31.12,7903,0
VIXM,7887,0,0.00,0,0.00,17.24,7687,200
MEAR,7463,0,0.00,0,0.00,50.01,7002,461
XSHD,7426,0,0.00,0,0.00,15.02,7426,0
BUYW,7305,0,0.00,0,0.00,13.44,6505,800
MAMB,7275,0,0.00,0,0.00,21.65,3400,3875
FNOV,7031,0,0.00,0,0.00,41.26,6931,100
JUCY,6886,0,0.00,0,0.00,23.98,6812,74
PTMC,6812,0,0.00,0,0.00,30.81,6812,0
EYLD,6588,0,0.00,0,0.00,29.77,6588,0
GCLN,6582,0,0.00,0,0.00,33.14,6582,0
GDE,6539,0,0.00,0,0.00,26.35,6539,0
GJUL,6528,0,0.00,0,0.00,31.20,6528,0
FLBL,6507,0,0.00,0,0.00,24.15,6507,0
SMMV,6311,0,0.00,0,0.00,34.15,4555,1756
REGL,6273,0,0.00,0,0.00,68.89,6273,0
DDLS,6238,0,0.00,0,0.00,31.32,5829,409
ARKX,6149,0,0.00,0,0.00,14.30,5899,250
IQDG,6131,0,0.00,0,0.00,34.13,5981,150
NUMG,6111,0,0.00,0,0.00,39.06,6111,0
VXZ,6079,0,0.00,0,0.00,14.91,6060,19
FRDM,5918,0,0.00,0,0.00,31.41,5918,0
DRSK,5756,0,0.00,0,0.00,24.26,5756,0
PMAY,5680,0,0.00,0,0.00,30.77,5680,0
DECZ,5571,0,0.00,0,0.00,31.15,5571,0
USMF,5506,0,0.00,0,0.00,40.58,5420,86
IBHG,5141,0,0.00,0,0.00,21.94,5141,0
DNOV,5132,0,0.00,0,0.00,37.62,5132,0
YJUN,5079,0,0.00,0,0.00,20.50,3279,1800
SATO,5059,0,0.00,0,0.00,9.67,4589,470
MPRO,5047,0,0.00,0,0.00,25.74,5047,0
FLHY,4973,0,0.00,0,0.00,22.95,4973,0
MFUL,4925,0,0.00,0,0.00,21.57,4925,0
GTIP,4813,0,0.00,0,0.00,47.89,2313,2500
IYLD,4691,0,0.00,0,0.00,19.40,4691,0
FCLD,4671,0,0.00,0,0.00,21.25,4670,1
NUEM,4579,0,0.00,0,0.00,26.58,4579,0
OILK,4551,0,0.00,0,0.00,44.09,4551,0
FLIA,4391,0,0.00,0,0.00,19.88,3985,406
IGE,4379,0,0.00,0,0.00,40.64,4379,0
PAPR,4364,0,0.00,0,0.00,31.98,4364,0
SHYD,4314,0,0.00,0,0.00,21.82,4314,0
PJAN,4181,0,0.00,0,0.00,36.67,4181,0
FPRO,4152,0,0.00,0,0.00,20.32,4152,0
IBML,4119,0,0.00,0,0.00,25.54,4119,0
PMAR,4051,0,0.00,0,0.00,34.99,4051,0
QSPT,3978,0,0.00,0,0.00,22.96,3978,0
BUFQ,3975,0,0.00,0,0.00,27.21,1828,2147
GDMN,3803,0,0.00,0,0.00,23.82,3803,0
TMFG,3692,0,0.00,0,0.00,27.62,3692,0
FLDR,3634,0,0.00,0,0.00,49.62,3634,0
HYGW,3612,0,0.00,0,0.00,33.88,3489,123
EAOK,3600,0,0.00,0,0.00,24.03,3600,0
EAOA,3591,0,0.00,0,0.00,30.81,3591,0
FPFD,3526,0,0.00,0,0.00,20.28,3526,0
FJAN,3472,0,0.00,0,0.00,38.52,3472,0
KOCT,3451,0,0.00,0,0.00,26.05,3451,0
TMFS,3408,0,0.00,0,0.00,27.39,3408,0
IBMP,3368,0,0.00,0,0.00,25.14,3368,0
TMFM,3363,0,0.00,0,0.00,24.13,3363,0
BUFG,3338,0,0.00,0,0.00,20.65,2538,800
BUFZ,3315,0,0.00,0,0.00,20.97,3315,0
HYDB,3301,0,0.00,0,0.00,47.53,3301,0
UJAN,3267,0,0.00,0,0.00,34.05,3267,0
RSBT,3257,0,0.00,0,0.00,17.16,3257,0
XDQQ,3257,0,0.00,0,0.00,26.04,3257,0
SECT,3217,0,0.00,0,0.00,44.38,3217,0
OMFS,3210,0,0.00,0,0.00,34.77,3210,0
IZRL,3194,0,0.00,0,0.00,17.93,3194,0
IBMM,3131,0,0.00,0,0.00,25.88,3071,60
BOXX,3122,0,0.00,0,0.00,104.62,3122,0
GSEW,3114,0,0.00,0,0.00,63.26,3014,100
TJUL,3109,0,0.00,0,0.00,25.12,3109,0
IGEB,3077,0,0.00,0,0.00,43.81,3077,0
NJUL,3008,0,0.00,0,0.00,53.39,2208,800
XUSP,3000,0,0.00,0,0.00,28.82,3000,0
QUVU,2999,0,0.00,0,0.00,22.41,2699,300
MSTB,2987,0,0.00,0,0.00,27.59,2987,0
WFHY,2984,0,0.00,0,0.00,44.06,2984,0
GJUN,2958,0,0.00,0,0.00,30.88,2958,0
BJUN,2943,0,0.00,0,0.00,34.45,2943,0
POCT,2894,0,0.00,0,0.00,35.34,2894,0
PAUG,2834,0,0.00,0,0.00,32.40,2834,0
BAMV,2802,0,0.00,0,0.00,26.85,2802,0
VFVA,2783,0,0.00,0,0.00,103.25,2783,0
DIVB,2726,0,0.00,0,0.00,38.71,2674,52
DFHY,2700,0,0.00,0,0.00,20.60,2700,0
FMAY,2659,0,0.00,0,0.00,40.10,2659,0
RULE,2632,0,0.00,0,0.00,19.70,2632,0
FLQM,2618,0,0.00,0,0.00,45.24,2618,0
OUSA,2617,0,0.00,0,0.00,44.41,2438,179
IBHE,2614,0,0.00,0,0.00,23.08,2414,200
YDEC,2600,0,0.00,0,0.00,21.82,1000,1600
STOT,2511,0,0.00,0,0.00,46.66,2511,0
XJR,2498,0,0.00,0,0.00,33.92,2498,0
ACIO,2467,0,0.00,0,0.00,32.26,2467,0
PBUS,2460,0,0.00,0,0.00,45.69,1758,702
TDV,2444,0,0.00,0,0.00,65.63,2344,100
SNOV,2429,0,0.00,0,0.00,20.07,2429,0
OGIG,2370,0,0.00,0,0.00,34.48,1328,1042
FAPR,2360,0,0.00,0,0.00,33.93,2360,0
GMOM,2360,0,0.00,0,0.00,26.91,860,1500
NOCT,2329,0,0.00,0,0.00,44.68,1485,844
PAWZ,2320,0,0.00,0,0.00,46.73,2320,0
RSEE,2317,0,0.00,0,0.00,24.34,2317,0
QDEC,2302,0,0.00,0,0.00,23.35,2006,296
KWT,2299,0,0.00,0,0.00,30.20,2299,0
SNAV,2289,0,0.00,0,0.00,26.96,2289,0
FAUG,2277,0,0.00,0,0.00,39.29,2277,0
IBHC,2267,0,0.00,0,0.00,23.69,2267,0
FJUN,2252,0,0.00,0,0.00,42.59,2252,0
SMB,2247,0,0.00,0,0.00,17.04,2247,0
YSEP,2242,0,0.00,0,0.00,19.94,2242,0
HOCT,2204,0,0.00,0,0.00,24.12,2204,0
EMHY,2180,0,0.00,0,0.00,35.33,1980,200
PNOV,2156,0,0.00,0,0.00,33.77,2156,0
BBEM,2146,0,0.00,0,0.00,48.13,1146,1000
EPRF,2144,0,0.00,0,0.00,18.18,2144,0
ENOR,2132,0,0.00,0,0.00,23.11,2132,0
PJUN,2099,0,0.00,0,0.00,32.68,1915,184
BAMG,2063,0,0.00,0,0.00,26.64,2063,0
FMIL,2043,0,0.00,0,0.00,34.71,2043,0
IBMO,2040,0,0.00,0,0.00,25.34,2040,0
HYMU,2026,0,0.00,0,0.00,21.44,2026,0
NUDM,2006,0,0.00,0,0.00,28.63,2006,0
GPOW,2000,0,0.00,0,0.00,42.04,2000,0
BBHY,1995,0,0.00,0,0.00,44.94,1795,200
IBMN,1995,0,0.00,0,0.00,26.45,1995,0
JPIB,1968,0,0.00,0,0.00,46.60,1968,0
TILT,1932,0,0.00,0,0.00,171.87,1632,300
LOCT,1928,0,0.00,0,0.00,24.04,1928,0
PRNT,1920,0,0.00,0,0.00,20.74,1920,0
VFMO,1908,0,0.00,0,0.00,120.10,1908,0
ICLO,1899,0,0.00,0,0.00,25.59,1899,0
HSRT,1887,0,0.00,0,0.00,38.54,1887,0
PSEP,1856,0,0.00,0,0.00,33.84,1639,217
FYLD,1850,0,0.00,0,0.00,24.31,1829,21
CLSE,1835,0,0.00,0,0.00,17.03,1835,0
BUFB,1818,0,0.00,0,0.00,26.80,1818,0
FFEB,1809,0,0.00,0,0.00,41.06,1809,0
UAPR,1798,0,0.00,0,0.00,26.93,1798,0
GLOV,1744,0,0.00,0,0.00,42.24,1744,0
XISE,1695,0,0.00,0,0.00,30.63,1295,400
XSEP,1633,0,0.00,0,0.00,35.15,1633,0
EMGF,1615,0,0.00,0,0.00,42.85,1615,0
NAPR,1603,0,0.00,0,0.00,43.72,1603,0
BALI,1598,0,0.00,0,0.00,26.08,1598,0
XJUN,1598,0,0.00,0,0.00,34.44,1518,80
FMAR,1595,0,0.00,0,0.00,36.92,1595,0
EFAD,1577,0,0.00,0,0.00,36.40,1577,0
MOTI,1541,0,0.00,0,0.00,30.62,1541,0
VEGN,1536,0,0.00,0,0.00,40.89,1535,1
DINT,1527,0,0.00,0,0.00,18.10,727,800
XAUG,1500,0,0.00,0,0.00,30.70,1500,0
BFEB,1497,0,0.00,0,0.00,35.21,1497,0
FCTR,1487,0,0.00,0,0.00,25.89,1487,0
STLG,1448,0,0.00,0,0.00,39.40,1448,0
VFMF,1448,0,0.00,0,0.00,106.57,623,825
JULH,1436,0,0.00,0,0.00,25.22,1436,0
XJH,1429,0,0.00,0,0.00,34.60,1429,0
VFMV,1403,0,0.00,0,0.00,101.24,490,913
TMAT,1402,0,0.00,0,0.00,14.71,1202,200
HEEM,1391,0,0.00,0,0.00,24.34,391,1000
DDEC,1386,0,0.00,0,0.00,35.28,1386,0
JULJ,1376,0,0.00,0,0.00,25.21,1376,0
FMAG,1347,0,0.00,0,0.00,23.12,1247,100
DDWM,1344,0,0.00,0,0.00,31.24,1344,0
DMAR,1342,0,0.00,0,0.00,33.38,1342,0
GJAN,1341,0,0.00,0,0.00,33.81,1341,0
QLC,1301,0,0.00,0,0.00,50.73,1202,99
XJUL,1260,0,0.00,0,0.00,31.38,1260,0
SDVD,1259,0,0.00,0,0.00,19.00,1259,0
PJUL,1245,0,0.00,0,0.00,35.12,1245,0
IETC,1244,0,0.00,0,0.00,59.40,744,500
RSST,1207,0,0.00,0,0.00,19.63,1207,0
BAMD,1203,0,0.00,0,0.00,26.39,1203,0
SAUG,1202,0,0.00,0,0.00,19.83,1202,0
BLKC,1189,0,0.00,0,0.00,14.88,1189,0
BUFD,1187,0,0.00,0,0.00,22.14,1187,0
FOCT,1184,0,0.00,0,0.00,37.98,1184,0
FLQL,1174,0,0.00,0,0.00,45.88,1174,0
FDRV,1159,0,0.00,0,0.00,15.66,1159,0
DAUG,1153,0,0.00,0,0.00,34.46,1153,0
HEGD,1152,0,0.00,0,0.00,18.88,1152,0
SHAG,1151,0,0.00,0,0.00,46.76,1151,0
USEP,1140,0,0.00,0,0.00,30.48,1140,0
IMFL,1131,0,0.00,0,0.00,24.10,1131,0
BMAY,1102,0,0.00,0,0.00,32.72,1102,0
DJUL,1099,0,0.00,0,0.00,35.42,1099,0
UMAY,1087,0,0.00,0,0.00,28.78,1087,0
DFND,1085,0,0.00,0,0.00,38.51,1085,0
GFEB,1085,0,0.00,0,0.00,32.23,1085,0
HYIN,1078,0,0.00,0,0.00,18.20,1078,0
IBMQ,1063,0,0.00,0,0.00,25.21,1063,0
XMPT,1061,0,0.00,0,0.00,20.50,1061,0
GAA,1046,0,0.00,0,0.00,27.02,1046,0
QMAR,1042,0,0.00,0,0.00,25.20,1042,0
JPLD,1024,0,0.00,0,0.00,50.29,1024,0
QJUN,1018,0,0.00,0,0.00,23.28,1018,0
BOCT,1004,0,0.00,0,0.00,37.35,1004,0
BAMY,1002,0,0.00,0,0.00,25.79,1002,0
BKGI,1000,0,0.00,0,0.00,27.66,1000,0
IDUB,986,0,0.00,0,0.00,19.69,986,0
TTAC,980,0,0.00,0,0.00,54.04,680,300
LQDI,973,0,0.00,0,0.00,25.44,973,0
GHYG,959,0,0.00,0,0.00,42.92,959,0
UAUG,945,0,0.00,0,0.00,29.75,945,0
VAMO,945,0,0.00,0,0.00,26.03,945,0
JCPI,943,0,0.00,0,0.00,45.71,943,0
MDLV,932,0,0.00,0,0.00,23.58,932,0
VCEB,932,0,0.00,0,0.00,61.48,932,0
OSCV,920,0,0.00,0,0.00,31.57,920,0
HFGO,912,0,0.00,0,0.00,15.96,912,0
EDEN,910,0,0.00,0,0.00,106.03,910,0
NETZ,907,0,0.00,0,0.00,54.27,907,0
EWUS,895,0,0.00,0,0.00,32.29,895,0
GVAL,894,0,0.00,0,0.00,20.70,894,0
ZALT,876,0,0.00,0,0.00,26.36,876,0
FDEC,855,0,0.00,0,0.00,37.31,855,0
GOCT,843,0,0.00,0,0.00,31.73,843,0
UOCT,842,0,0.00,0,0.00,31.64,842,0
MOHR,835,0,0.00,0,0.00,19.10,835,0
XBJL,823,0,0.00,0,0.00,29.89,823,0
APRD,818,0,0.00,0,0.00,25.16,818,0
MSVX,799,0,0.00,0,0.00,24.36,699,100
RODE,792,0,0.00,0,0.00,25.90,792,0
XBTF,786,0,0.00,0,0.00,35.98,786,0
FSMO,783,0,0.00,0,0.00,21.64,783,0
WDNA,779,0,0.00,0,0.00,15.18,779,0
DOCT,778,0,0.00,0,0.00,35.61,778,0
XDEC,772,0,0.00,0,0.00,33.79,772,0
ADME,757,0,0.00,0,0.00,37.17,757,0
BUFT,753,0,0.00,0,0.00,20.48,753,0
BJUL,738,0,0.00,0,0.00,36.21,738,0
NULC,736,0,0.00,0,0.00,37.67,736,0
BAUG,731,0,0.00,0,0.00,34.75,731,0
TTAI,711,0,0.00,0,0.00,27.94,711,0
TOKE,710,0,0.00,0,0.00,5.59,710,0
ATMP,703,0,0.00,0,0.00,21.94,703,0
DUSA,703,0,0.00,0,0.00,33.70,703,0
XBJA,699,0,0.00,0,0.00,25.57,699,0
FSEP,690,0,0.00,0,0.00,38.93,690,0
OEUR,687,0,0.00,0,0.00,27.54,687,0
XVV,680,0,0.00,0,0.00,34.84,680,0
DFEB,661,0,0.00,0,0.00,36.53,661,0
JBBB,644,0,0.00,0,0.00,47.69,644,0
DFNL,631,0,0.00,0,0.00,28.50,631,0
ARKZ,619,0,0.00,0,0.00,25.77,619,0
GSID,608,0,0.00,0,0.00,51.30,608,0
MOTG,607,0,0.00,0,0.00,33.44,507,100
DJAN,600,0,0.00,0,0.00,34.00,600,0
SMAY,597,0,0.00,0,0.00,20.61,597,0
NANC,594,0,0.00,0,0.00,29.00,594,0
FDEV,592,0,0.00,0,0.00,25.74,592,0
UJUL,582,0,0.00,0,0.00,29.41,582,0
DMAY,579,0,0.00,0,0.00,35.37,579,0
TYA,579,0,0.00,0,0.00,13.18,479,100
HYBL,562,0,0.00,0,0.00,27.81,462,100
FUNL,556,0,0.00,0,0.00,35.01,556,0
GSST,554,0,0.00,0,0.00,50.10,554,0
CAOS,544,0,0.00,0,0.00,82.83,544,0
FRNW,528,0,0.00,0,0.00,15.45,528,0
XTJA,528,0,0.00,0,0.00,23.97,528,0
IGLD,525,0,0.00,0,0.00,19.05,525,0
DWLD,521,0,0.00,0,0.00,28.22,521,0
RPHS,521,0,0.00,0,0.00,9.09,521,0
LEAD,518,0,0.00,0,0.00,58.48,518,0
DALT,508,0,0.00,0,0.00,8.55,508,0
MRGR,503,0,0.00,0,0.00,40.06,503,0
ROMO,501,0,0.00,0,0.00,25.88,501,0
DJUN,500,0,0.00,0,0.00,36.82,500,0
EALT,500,0,0.00,0,0.00,26.87,500,0
PSCJ,500,0,0.00,0,0.00,22.46,500,0
PTEU,500,0,0.00,0,0.00,24.48,500,0
KJAN,487,0,0.00,0,0.00,30.80,487,0
XDAT,487,0,0.00,0,0.00,20.63,487,0
FBCV,478,0,0.00,0,0.00,28.13,478,0
DUBS,459,0,0.00,0,0.00,26.03,459,0
RESD,458,0,0.00,0,0.00,28.26,458,0
CSM,457,0,0.00,0,0.00,52.13,420,37
FIBR,450,0,0.00,0,0.00,84.61,450,0
XNOV,450,0,0.00,0,0.00,30.85,450,0
HYHG,440,0,0.00,0,0.00,62.27,440,0
KJUL,437,0,0.00,0,0.00,25.39,437,0
KAPR,430,0,0.00,0,0.00,27.01,430,0
XOCT,428,0,0.00,0,0.00,31.39,428,0
IQM,426,0,0.00,0,0.00,47.74,426,0
IGRO,425,0,0.00,0,0.00,61.86,425,0
BAPR,414,0,0.00,0,0.00,36.94,414,0
BRLN,414,0,0.00,0,0.00,52.65,414,0
AFIF,407,0,0.00,0,0.00,8.97,407,0
EFNL,402,0,0.00,0,0.00,34.31,402,0
GAPR,402,0,0.00,0,0.00,32.05,402,0
BBLB,400,0,0.00,0,0.00,87.57,400,0
NUDV,400,0,0.00,0,0.00,24.31,400,0
PSMO,400,0,0.00,0,0.00,24.63,400,0
EFUT,393,0,0.00,0,0.00,19.44,193,200
NJAN,388,0,0.00,0,0.00,41.43,388,0
FLQS,385,0,0.00,0,0.00,35.39,385,0
BJAN,380,0,0.00,0,0.00,39.02,380,0
TBJL,362,0,0.00,0,0.00,19.09,362,0
IGHG,354,0,0.00,0,0.00,75.98,354,0
FPAG,352,0,0.00,0,0.00,25.10,352,0
LKOR,325,0,0.00,0,0.00,42.32,325,0
BMAR,320,0,0.00,0,0.00,38.36,320,0
YMAR,317,0,0.00,0,0.00,21.05,317,0
EAOM,314,0,0.00,0,0.00,25.47,314,0
BSEP,312,0,0.00,0,0.00,35.45,312,0
AESR,303,0,0.00,0,0.00,13.06,303,0
ARKY,302,0,0.00,0,0.00,25.32,302,0
HAUS,286,0,0.00,0,0.00,15.16,286,0
PFEB,274,0,0.00,0,0.00,31.84,274,0
TSJA,272,0,0.00,0,0.00,27.90,272,0
GDMA,268,0,0.00,0,0.00,30.60,268,0
VFQY,262,0,0.00,0,0.00,117.83,262,0
APRQ,250,0,0.00,0,0.00,24.85,250,0
ZECP,243,0,0.00,0,0.00,25.46,243,0
UMAR,230,0,0.00,0,0.00,31.06,230,0
BLDG,222,0,0.00,0,0.00,23.52,222,0
NVDQ,222,0,0.00,0,0.00,23.55,222,0
QPFF,213,0,0.00,0,0.00,35.28,213,0
GAUG,207,0,0.00,0,0.00,30.74,207,0
IVVM,206,0,0.00,0,0.00,26.23,206,0
IPDP,205,0,0.00,0,0.00,16.23,205,0
SJIM,205,0,0.00,0,0.00,22.18,107,98
ADFI,204,0,0.00,0,0.00,8.41,204,0
HSUN,203,0,0.00,0,0.00,33.13,203,0
QVOY,203,0,0.00,0,0.00,27.65,203,0
ROYA,203,0,0.00,0,0.00,25.28,203,0
FFOG,202,0,0.00,0,0.00,27.52,202,0
BEMB,201,0,0.00,0,0.00,50.52,201,0
GHEE,201,0,0.00,0,0.00,25.40,201,0
IBMR,200,0,0.00,0,0.00,25.01,200,0
PSCQ,200,0,0.00,0,0.00,23.53,200,0
TOLL,200,0,0.00,0,0.00,27.17,200,0
XDOC,200,0,0.00,0,0.00,26.52,0,200
DAPR,191,0,0.00,0,0.00,31.63,191,0
HCRB,189,0,0.00,0,0.00,34.03,189,0
XDJL,189,0,0.00,0,0.00,28.96,189,0
AAPY,188,0,0.00,0,0.00,26.61,188,0
FCPI,182,0,0.00,0,0.00,33.80,182,0
BNOV,178,0,0.00,0,0.00,34.04,178,0
UFEB,168,0,0.00,0,0.00,28.90,168,0
FEBZ,166,0,0.00,0,0.00,31.53,166,0
MSMR,163,0,0.00,0,0.00,24.47,163,0
IBHI,160,0,0.00,0,0.00,22.43,160,0
ESEB,155,0,0.00,0,0.00,16.50,155,0
FLTN,151,0,0.00,0,0.00,19.97,151,0
BCHP,145,0,0.00,0,0.00,27.41,145,0
SEIM,143,0,0.00,0,0.00,26.58,143,0
ARKD,138,0,0.00,0,0.00,27.70,14,124
RMIF,138,0,0.00,0,0.00,24.95,138,0
GSEP,137,0,0.00,0,0.00,30.83,137,0
BUSA,124,0,0.00,0,0.00,26.02,124,0
DFNV,123,0,0.00,0,0.00,26.38,123,0
RDFI,123,0,0.00,0,0.00,21.87,123,0
RESE,121,0,0.00,0,0.00,28.25,121,0
XDSQ,121,0,0.00,0,0.00,29.27,121,0
KRUZ,119,0,0.00,0,0.00,26.02,119,0
EMDV,118,0,0.00,0,0.00,43.36,118,0
OCTH,114,0,0.00,0,0.00,24.50,114,0
OCTQ,107,0,0.00,0,0.00,24.22,7,100
QTOC,107,0,0.00,0,0.00,24.68,107,0
TMDV,107,0,0.00,0,0.00,44.75,107,0
INTL,104,0,0.00,0,0.00,21.35,3,101
TSLP,104,0,0.00,0,0.00,27.80,4,100
ESGG,102,0,0.00,0,0.00,143.67,102,0
IBHJ,102,0,0.00,0,0.00,25.40,102,0
GHMS,101,0,0.00,0,0.00,25.49,101,0
OCTD,101,0,0.00,0,0.00,24.64,101,0
TRTY,101,0,0.00,0,0.00,24.81,101,0
APRH,100,0,0.00,0,0.00,25.06,100,0
GSEE,100,0,0.00,0,0.00,40.60,100,0
LCF,100,0,0.00,0,0.00,29.51,100,0
TGLR,100,0,0.00,0,0.00,23.89,100,0
XBAP,100,0,0.00,0,0.00,30.07,100,0
GEMD,98,0,0.00,0,0.00,39.39,98,0
EMTL,96,0,0.00,0,0.00,40.90,96,0
HEAT,89,0,0.00,0,0.00,23.68,89,0
FDHT,84,0,0.00,0,0.00,17.25,84,0
WEED,84,0,0.00,0,0.00,29.17,84,0
UNOV,82,0,0.00,0,0.00,30.97,82,0
ARKC,80,0,0.00,0,0.00,25.39,80,0
DKRB,79,0,0.00,0,0.00,25.11,79,0
ESG,79,0,0.00,0,0.00,111.71,79,0
EGUS,75,0,0.00,0,0.00,32.18,74,1
EAOR,64,0,0.00,0,0.00,27.96,64,0
SVAL,62,0,0.00,0,0.00,27.35,62,0
AMZP,55,0,0.00,0,0.00,26.60,55,0
HELX,50,0,0.00,0,0.00,28.01,50,0
MBNE,48,0,0.00,0,0.00,29.31,48,0
BAMA,39,0,0.00,0,0.00,26.17,39,0
FAIL,39,0,0.00,0,0.00,18.00,39,0
SFIG,37,0,0.00,0,0.00,47.26,37,0
GMAR,33,0,0.00,0,0.00,32.86,33,0
SEIV,32,0,0.00,0,0.00,26.54,32,0
IAUF,29,0,0.00,0,0.00,60.95,29,0
PBTP,25,0,0.00,0,0.00,24.77,25,0
FDTB,20,0,0.00,0,0.00,10.14,20,0
RVRB,20,0,0.00,0,0.00,23.97,20,0
MSFY,19,0,0.00,0,0.00,26.47,19,0
IEDI,18,0,0.00,0,0.00,41.15,18,0
MBBB,16,0,0.00,0,0.00,20.80,16,0
ARKA,15,0,0.00,0,0.00,38.19,15,0
DURA,14,0,0.00,0,0.00,30.23,14,0
BGLD,13,0,0.00,0,0.00,20.69,13,0
TSLH,12,0,0.00,0,0.00,25.77,12,0
DFRA,10,0,0.00,0,0.00,27.86,10,0
GOOP,10,0,0.00,0,0.00,26.10,10,0
NOVZ,9,0,0.00,0,0.00,34.31,9,0
RYSE,8,0,0.00,0,0.00,30.34,8,0
APRJ,7,0,0.00,0,0.00,24.94,7,0
MBND,7,0,0.00,0,0.00,26.99,7,0
MAGA,6,0,0.00,0,0.00,39.61,6,0
EUDV,4,0,0.00,0,0.00,44.64,4,0
FDEM,4,0,0.00,0,0.00,23.09,4,0
IVVB,4,0,0.00,0,0.00,25.63,4,0
JULD,4,0,0.00,0,0.00,25.18,4,0
PIT,4,0,0.00,0,0.00,53.43,4,0
PSFO,4,0,0.00,0,0.00,25.22,4,0
WUGI,4,0,0.00,0,0.00,48.36,4,0
BUYZ,3,0,0.00,0,0.00,26.99,3,0
DWAT,3,0,0.00,0,0.00,10.02,3,0
HYXU,3,0,0.00,0,0.00,49.07,3,0
QTJA,3,0,0.00,0,0.00,21.06,3,0
DBJA,2,0,0.00,0,0.00,29.27,2,0
DSJA,2,0,0.00,0,0.00,29.60,2,0
ESHY,2,0,0.00,0,0.00,18.16,2,0
GMAY,2,0,0.00,0,0.00,32.14,2,0
MINN,2,0,0.00,0,0.00,21.94,2,0
PEX,2,0,0.00,0,0.00,27.44,2,0
RTAI,2,0,0.00,0,0.00,19.96,2,0
SHDG,2,0,0.00,0,0.00,24.37,2,0
WBAT,2,0,0.00,0,0.00,29.68,2,0
WLDR,2,0,0.00,0,0.00,26.24,2,0
XVOL,2,0,0.00,0,0.00,17.74,2,0
ZIVB,2,0,0.00,0,0.00,22.06,2,0
ARCM,1,0,0.00,0,0.00,100.14,1,0
DOGG,1,0,0.00,0,0.00,19.99,1,0
IVRA,1,0,0.00,0,0.00,13.42,1,0
SANE,1,0,0.00,0,0.00,22.81,1,0
SUPP,1,0,0.00,0,0.00,51.69,1,0
VIRS,1,0,0.00,0,0.00,30.46,1,0
ACSI,0,0,0.00,0,0.00,0.00,0,0
APRZ,0,0,0.00,0,0.00,0.00,0,0
AUGZ,0,0,0.00,0,0.00,0.00,0,0
BAMB,0,0,0.00,0,0.00,0.00,0,0
BAMO,0,0,0.00,0,0.00,0.00,0,0
BAMU,0,0,0.00,0,0.00,0.00,0,0
BBIB,0,0,0.00,0,0.00,0.00,0,0
BBIP,0,0,0.00,0,0.00,0.00,0,0
BBSA,0,0,0.00,0,0.00,0.00,0,0
BBSB,0,0,0.00,0,0.00,0.00,0,0
BHYB,0,0,0.00,0,0.00,0.00,0,0
BINV,0,0,0.00,0,0.00,0.00,0,0
BSMC,0,0,0.00,0,0.00,0.00,0,0
BWTG,0,0,0.00,0,0.00,0.00,0,0
CFCV,0,0,0.00,0,0.00,0.00,0,0
CMCI,0,0,0.00,0,0.00,0.00,0,0
CVAR,0,0,0.00,0,0.00,0.00,0,0
DSCF,0,0,0.00,0,0.00,0.00,0,0
DSEP,0,0,0.00,0,0.00,0.00,0,0
DWCR,0,0,0.00,0,0.00,0.00,0,0
ESCR,0,0,0.00,0,0.00,0.00,0,0
EVUS,0,0,0.00,0,0.00,0.00,0,0
FDCE,0,0,0.00,0,0.00,0.00,0,0
FDGR,0,0,0.00,0,0.00,0.00,0,0
FDVL,0,0,0.00,0,0.00,0.00,0,0
FLDZ,0,0,0.00,0,0.00,0.00,0,0
GLDB,0,0,0.00,0,0.00,0.00,0,0
GPAL,0,0,0.00,0,0.00,0.00,0,0
HIYS,0,0,0.00,0,0.00,0.00,0,0
IMSI,0,0,0.00,0,0.00,0.00,0,0
IPPP,0,0,0.00,0,0.00,0.00,0,0
ISDB,0,0,0.00,0,0.00,0.00,0,0
ISVL,0,0,0.00,0,0.00,0.00,0,0
JANZ,0,0,0.00,0,0.00,0.00,0,0
JULQ,0,0,0.00,0,0.00,0.00,0,0
JULZ,0,0,0.00,0,0.00,0.00,0,0
JUNZ,0,0,0.00,0,0.00,0.00,0,0
KCAL,0,0,0.00,0,0.00,0.00,0,0
LGLZ,0,0,0.00,0,0.00,0.00,0,0
MARZ,0,0,0.00,0,0.00,0.00,0,0
MAYZ,0,0,0.00,0,0.00,0.00,0,0
MDEV,0,0,0.00,0,0.00,0.00,0,0
MIG,0,0,0.00,0,0.00,0.00,0,0
MOTE,0,0,0.00,0,0.00,0.00,0,0
MSTQ,0,0,0.00,0,0.00,0.00,0,0
NFLP,0,0,0.00,0,0.00,0.00,0,0
OBND,0,0,0.00,0,0.00,0.00,0,0
OCTJ,0,0,0.00,0,0.00,0.00,0,0
OCTZ,0,0,0.00,0,0.00,0.00,0,0
PBL,0,0,0.00,0,0.00,0.00,0,0
PSCW,0,0,0.00,0,0.00,0.00,0,0
PSCX,0,0,0.00,0,0.00,0.00,0,0
PSDM,0,0,0.00,0,0.00,0.00,0,0
PSFD,0,0,0.00,0,0.00,0.00,0,0
PSFJ,0,0,0.00,0,0.00,0.00,0,0
PSFM,0,0,0.00,0,0.00,0.00,0,0
PSMD,0,0,0.00,0,0.00,0.00,0,0
PSMJ,0,0,0.00,0,0.00,0.00,0,0
PSMR,0,0,0.00,0,0.00,0.00,0,0
PUTD,0,0,0.00,0,0.00,0.00,0,0
QCON,0,0,0.00,0,0.00,0.00,0,0
QTAP,0,0,0.00,0,0.00,0.00,0,0
QTJL,0,0,0.00,0,0.00,0.00,0,0
SEIQ,0,0,0.00,0,0.00,0.00,0,0
SELV,0,0,0.00,0,0.00,0.00,0,0
SEPZ,0,0,0.00,0,0.00,0.00,0,0
SMI,0,0,0.00,0,0.00,0.00,0,0
SNPD,0,0,0.00,0,0.00,0.00,0,0
SNPG,0,0,0.00,0,0.00,0.00,0,0
SNPV,0,0,0.00,0,0.00,0.00,0,0
SPCZ,0,0,0.00,0,0.00,0.00,0,0
SPMV,0,0,0.00,0,0.00,0.00,0,0
TDVI,0,0,0.00,0,0.00,0.00,0,0
TFJL,0,0,0.00,0,0.00,0.00,0,0
TUSI,0,0,0.00,0,0.00,0.00,0,0
UJUN,0,0,0.00,0,0.00,0.00,0,0
VMAT,0,0,0.00,0,0.00,0.00,0,0
VWID,0,0,0.00,0,0.00,0.00,0,0
WFIG,0,0,0.00,0,0.00,0.00,0,0
XBOC,0,0,0.00,0,0.00,0.00,0,0
XDAP,0,0,0.00,0,0.00,0.00,0,0
XDJA,0,0,0.00,0,0.00,0.00,0,0
XEMD,0,0,0.00,0,0.00,0.00,0,0
XTAP,0,0,0.00,0,0.00,0.00,0,0
XTJL,0,0,0.00,0,0.00,0.00,0,0
XTOC,0,0,0.00,0,0.00,0.00,0,0
YPS,0,0,0.00,0,0.00,0.00,0,0